XXXXXXXXXX
XX---XX--X
X--X-----F
XP--XXX--F
X--------F
XXXX----XX
XXXXXXXXXX
