XXXXXXXXXXXXXXXXXXXXXXXXXXXXXXXXXXXXXXXXXXXXXXXXXXXXXXXXXXXXXXXXXXXXXXXXXXXXXXXXXXXXXXXXXXXXXXXXXXX
X--------X-------X---X---X-------X---X---X---X---X---X-------X-------X-------X---X---X---X---X----F
X----X---X---X---X---X---X---X---X---X-----------X---X---X---X---X---X---X---X-------X---X---X----F
X----X---X---X---X-------X---X---X---X---X---X---X---X---X---X---X---X---X---X---X---X---X--------F
X-P--X---X---X---X---X---X---X-------X---X---X---X---X---X---X---X---X---X---X---X---X---X---X----F
X----X---X---X---X---X---X---X---X---X---X---X-------X---X-------X---X---X---X---X-------X---X----F
X----X-------X-------X-------X---X---X---X---X---X---X---X---X---X-------X-------X---X---X---X----F
X----X---X---X---X---X---X---X---X-------X---X---X-------X---X---X---X---X---X---X---X-------X----F
XXXXXXXXXXXXXXXXXXXXXXXXXXXXXXXXXXXXXXXXXXXXXXXXXXXXXXXXXXXXXXXXXXXXXXXXXXXXXXXXXXXXXXXXXXXXXXXXXXX
XXXXXXXXXXXXXXXXXXXXXXXXXXXXXXXXXXXXXXXXXXXXXXXXXXXXXXXXXXXXXXXXXXXXXXXXXXXXXXXXXXXXXXXXXXXXXXXXXXX
X----X---X-------X---X---X---X---X-------X-------X---X-------X---X---X-------X---X---X---X--------F
X----X---X---X---X-------X---X---X---X---X---X---X---X---X---X---X---X---X---X---X---X---X---X----F
X----X---X---X---X---X---X-------X---X---X---X---X---X---X---X---X---X---X---X---X---X---X---X----F
X-P--X---X---X---X---X---X---X---X---X---X---X---X-------X---X-------X---X---X---X-------X---X----F
X----X---X---X---X---X---X---X---X---X---X---X---X---X---X---X---X---X---X---X---X---X---X---X----F
X----X---X---X-------X-------X-------X---X---X---X---X---X---X---X---X---X---X---X---X---X---X----F
X------------X---X---X---X---X---X---X-------X-------X---X-------X-------X-----------X-------X----F
XXXXXXXXXXXXXXXXXXXXXXXXXXXXXXXXXXXXXXXXXXXXXXXXXXXXXXXXXXXXXXXXXXXXXXXXXXXXXXXXXXXXXXXXXXXXXXXXXXX