XXXXXXXXXXXXXXXXXXXXXXXXX
X-P--------XX----X-X-P--X
X-XX------XX---XXX---X--X
X--X--------X--XX---XX--X
X----XX----XX----X------X
X-----X---X-XX-X--XX----X
X----X---X----XX--X-XX--X
X----X--XXX----XX---X-X-X
X-X-X--X---X-XXXX-XX----X
X---X----X-X--XXXXXXXX--X
X----X-X--X-X-X-XXXXX---X
X--X-X----X-X--X-X-XX---X
X-XX--X--XXXX-XXX-XXX-X-X
X---X----X--X----X-----XX
X-----X---XX-XX----XXX--X
X------X-XX--XX-X-X--X--X
X-----X-X-X--X--X--XXX--X
X----X----XX-XX--XX--X--X
X---X----X-X-X---XXXX---X
X------X--X--X-X---XX---X
X-------XXXXXX--XX---XX-X
X--------X---X---X-X-X--X
X--X-X---XXXXX---X------X
X-----XX-X----XX---XX---X
X-XX---X---X-X-XX----XXXX
X--------X-XX---XXXX----X
X----XX---X--XX-X----XX-X
X----XX-X-X------XX----XX
F---------X--XXXX-------F
F-----X--XXX----X-------F
FFFXXXXXXXXXXXXXXXXXXXFFF