XXXXXXXXXXXXXXXXXXXXXXXXXXXXXXXXXXXXXXXX
X--------------------------------------X
X-XXXXXXXXXXXXX-X---X-XXXXXXXXXXXXXXXX-X
X----X-XX-----X---XX--X----X----X--XX--X
X-----X-------X-XX----X------X-X--XX---X
X-X-X-X-X-----X--XX--XX---X---X------X-X
X----X--------X--XX---X------XXX---X---X
X--------X----X---X---X------X-XXX-----X
X--XX--X---X--X---X---X--------XX--XX--X
X--X--X--X----X-XX--X-X---X-XXXX-XX-XXXX
X-X-X-X-X--X--X---X---X-----X-X-X--X---X
X--X--X-X--X--X--XX---X--X----XX-------X
XX-XX--X---X--X-----X-X--X-X----X----X-X
X--X---XX-----X-------X--X-----XX---X--X
X----X----X---X--XX---X------XX------X-X
X--X--X---X---X--XX---X--X---X--X--X-X-X
X--X-X--X-----X--XX---X--X---X----X----X
XX--X--X--X---X---XX--X-X-X-X-X--X-X---X
X-P--X--X--X--X-X---X-X---XXXX-XX-X--P-X
X--XX---X---XXX-------XXX---XXXX-------X
XXXXXXXXXXXXXXXFFFFFFFXXXXXXXXXXXXXXXXXX