XXXXXXXXXXXXXXXXXXXXXXXXXXXXXXXXXXXX
X-P--XXXXXXX-X--X-XXXX-----XXX---P-X
X--XX-XX-------X--------XXXXXX-XX--X
X---XXX--X--XX--X-------X-------X--X
X----XX--X---XX--------X---X----XX-X
X--------X-XXX---XX--X----XX-------X
X--XXXX--XX---XX-------XXX-XX-----XX
X-------XX--X--X--X--------XX-XXXX-X
XXXX--X---XX-X-XXX---XXXXX----X----X
XXXXXX-X----X-XXXXX------X----XXX--X
X--------XXXXXXXXXX-------XX-------X
X--X-------XXXXX----XXXXXXX-XXXX---X
X--X--X-XX-XXX-X-X------XX-X-------X
X--X------X-X--X-----XXXXX-X-XXX---X
X--X-X----XX---XXX--------X-XX-----X
XXX--X----XX---XXX---XXXXXX---X----X
X-X---XX-X-XX---X---------XXX-XX---X
X-X---XX-X---XX--XXXXXXXXX---XXX---X
X-X---XX-------X------XXXX---XXXX--X
X-XXXX-X---XXX-------X---------XXX-X
XFFFFFFFFFFFFFFFFFFFFFFFFFFFFFFFFFFX
