XXXXXXXXXXXXXXXXXXXXXXXXXXXXXXXXXXXXXXXXXXXXXXXXXX
X--P-------------------------------------XX---P--X
X----------------------------------XX--XX--------X
X------------------------------------------------X
X-X-XXXXXXXXXXXXXXXXXXXXXXXXXXXXXXXXXXXXXXXXXX-X-X
X-X-XXXXXXXXXXXXXXXXXXXXXXXXXXXXXXXXXXXXXXXXXX-X-X
X-X-XXXXXXXXXXXXXXXXXXXXXXXXXXXXXXXXXXXXXXXXXX-X-X
X-X-XXXXXXXXXXXXXXXXXXXXXXXXXXXXXXXXXXXXXXXXXX-X-X
X-X-XXXXXXXXXXXXXXXXXXXXXXXXXXXXXXXXXXXXXXXXXX-X-X
X-X-XXXXXXXXXXXXXXXXXXXXXXXXXXXXXXXXXXXXXXXXXX-X-X
X-X-XXXXXXXXXXXXXXXXXXXXXXXXXXXXXXXXXXXXXXXXXX-X-X
X-X-XXXXXXXXXXXXXXXXXXXXXXXXXXXXXXXXXXXXXXXXXX-X-X
X-X-XXXXXXXXXXXXXXXX----------XXXXXXXXXXXXXXXX-X-X
X-X-XXXXXXXXXXXXXXXX--FFFFFF--XXXXXXXXXXXXXXXX-X-X
X--X--------------X---XXXXXX---X----------------XX
X---X-------------X------X-----X--------X---X----X
X----X------------X--XX--X-X--X--X-----X--X---X--X
X-----X-----------X------X--X-XX-------X--------XX
X------X----------X-XX---X-----X--------XX---X---X
X--XX-XXX---------X----XXX--X---X----------X---X-X
XXX------X--------X-XX---X--X---X----------X-----X
X----XX-----------X--XX--X--X--X----------X---XX-X
X--XXX--XXXXXXXXXXX------X-X---XXXXXXXXXXX----XX-X
X-----X---X-----X--------X-----------XX----------X
X--X---------X-------XX----XX---XX-------X--XX---X
XXXXXXXXXXXXXXXXXXXXXXXXXXXXXXXXXXXXXXXXXXXXXXXXXX
