XXXXXXXXXXXXXXXXXXXXXXXXXXXXXXXXXXXXXXXXXXXXX
X-P---------XXXX---------XXX------XX------P-X
XX-------------XXX---------------------XX---X
X--XXX----------------XXX---XX-------XXXX---X
X------XXXX---------------------------------X
X----------XXX-----------XXX--XX--XXX-------X
X---------------------XX--------XX-----XX---X
X--XXXX----XXXXXXXX--------XXXXXXXX---------X
X---------X--------X------X--------X----X---X
X----X---X---FFF----X----X----FFF---X--X--X-X
X--------X-----------X--X-----------X--X----X
X--X---X-X------------XX------------X---XX--X
X---X-----X------------------------X----X---X
X---X---X--X----------------------X--XX-XX--X
X---X-X-X---X--------------------X-----XX---X
X----XXX-----X------------------X------XX---X
X-------XX-X--X----------------X-------XX---X
X---XX-XX---X--X--------------X---XX---XX---X
X------XXX------X------------X----XXX--XX---X
X------------X---X----------X---------------X
X-----XX----------X--------X-XXX----XX--XXX-X
X----------X-X-----X------X------------XX---X
X------XX---X--X----------------XX----------X
X---XX-----------X---X--X----------XXX------X
X--------XX---XXX-----XX----XX---------XX---X
X--------------X---------------XXX----XX----X
X-----XXXX---X---------------XX-------------X
XXXXXXXXXXXXXXXXXXXXXXXXXXXXXXXXXXXXXXXXXXXXX