XXXXXXXXXX
XX---XX--X
XP-------F
XP--XXX--F
X--------F
XXXX----XX
XXXXXXXXXX
