XXXXXXXXXXXXXXX
X-------------F
X------X------F
X------X------F
X----XX--XX---X
X-XXXXXXXX----X
X--------X----X
X-----X---X---X
X----X----X---X
X----XXXX----XX
XX---X-XX-X-X-X
X-X----XX----XX
X--X-----XX-X-X
X---X--XXX----X
X----X-----X--X
X-----X------XX
X------X----X-X
X-------X-----X
X--------X--X-X
X---------X--XX
X----------X-XX
XXXXXXXXXXXX--X
X--XXXXXXXXX--X
X-P-----------X
XXXXXXXXXXXXXXX