XXXXXXXXXXXXXXXXXXXXXXXXXXXXXXXXXXXXXXXXXXXXXXXXXX
X-P--------------XXXXXXXX---XXX-----XXXXXXX------X
X------------------------XXX-----XXXXXXXXXXXXXX--X
X-----------------------XXXXX--X-XXXXXX-----X----X
XXXXXXX------------XX----------X------------XXX--X
X------XXXX----------XX------------X---------XXXXX
XXXXXXXXXXXXXXX-------------------X----------X---F
X--------------XXXX----XXXXXXXXX----X------------F
X------------------XXX-----X------XXXXXXXX--X----F
X------------------XXXX--XX--------------XXXX----X
X----------------------XX---X-XXXXXXX--XX--------X
X------------------------XXX-X-----------X-------X
XXXXXXXXXXXXXXXXXXXXXXXXXXXXXXXXXXXXXXXXXXXXXXXXXX
