XXXXXXXXXXXXXXXXXXXXXXXXXXXXXXXXXXXXXXXXXXXXXXXXXX
X-P-------------------------XXX-----------X------X
X------------------------XXX-----------------XX--X
X------------------------------X------------X----X
XXXXXXX-------------------------X--------------X-X
X------XXXX----------XX------------X------------XX
X----------XXXX-------------------X----------X---F
X--------------XXXX----X------------X------------F
X------------------XXX-----X------------XX--X----F
X------------------XXXX--XX-----------------X----X
X----------------------XX---X----------XX--------X
X------------------------XXX-X-----------X-------X
XXXXXXXXXXXXXXXXXXXXXXXXXXXXXXXXXXXXXXXXXXXXXXXXXX