XXXXXXXXXXXXXXXXXXXXXXXXXXXXXXXXXXXXXXXXXXXXXXXXXX
X------------------------------------------------X
X-----------------XXXXXXXXXX---------------------X
X---------------XX----------XX-----------XXX-----X
X-----------XXX--------------------------X----XX-X
X----------------X----------X------------XXXX----X
X------------------------------------------------X
X-----------------X------------------------------X
X------------XX---------X------------------------X
X----------------X--------X----------------------X
X------------------------X-----------------------X
X----------------X--------XXXXXX---------XX------X
X-------------------------------XXX-------XX-----F
X-----------------------------------X------X-----F
X------------------------------------X-----X-----F
X--------------------------------------X---X-----F
XXX--X--------XXXXXX---------------------X-------F
X---X------------------------------------X--X----F
X---X-------------X----------------------X----X--X
XX----------------X----------------------X-------X
X-----------------X------------------------------X
X--------------XXXXXXXX--------------------------X
X-------------------XXXXX------------------------X
X----XX------------XXX--------------------X------X
X----XX----------------X------------------X------X
X----XX-----------------X-----------------X------X
X----XX------------------XX---------------X------X
X----XX-----------------------------------X------X
X----XX-------------------X---------------X------X
X----XXX------------------X---------------X------X
X------XX-----------------X---------------X------X
X--P------------------XXXXXXXXXXXX--------X------X
X-------XX--------------------------------X------X
XXXXXXXXXXXXXXXXXXXXXXXXXXXXXXXXXXXXXXXXXXXXXXXXXX	

